1111111
1PEC0C1
11111C1
1111111
